[console_scripts]
autoassist = toolmate.autoassist:main
autobuilder = toolmate.autobuilder:main
autoretriever = toolmate.autoretriever:main
chatgpt = toolmate.chatgpt:main
chatserver = toolmate.servers:chat
codey = toolmate.codey:main
commandprompt = toolmate.commandprompt:main
customchatserver = toolmate.servers:customchat
customtoolserver = toolmate.servers:custommain
customvisionserver = toolmate.servers:customvision
etextedit = toolmate.eTextEdit:main
geminipro = toolmate.geminipro:main
geminiprovision = toolmate.geminiprovision:main
groqchat = toolmate.groqchat:main
letmedoit = toolmate.main:letmedoit
llamacpp = toolmate.llamacpp:main
llamacppserver = toolmate.llamacppserver:main
mistralchat = toolmate.mistralchat:main
ollamachat = toolmate.ollamachat:main
palm2 = toolmate.palm2:main
rag = toolmate.rag:main
tm = toolmate.api_client:main
tmc = toolmate.api_client:chat
tmcmd = toolmate.api_client:cmd
tmconfigs = toolmate.api_client:configs
tmserver = toolmate.api_server:main
tmsetup = toolmate.setup:main
tmtask = toolmate.api_client:task
toolmate = toolmate.main:main
toolmateai = toolmate.systemtray:main
toolmateclient = toolmate.api_client:main
toolmatelite = toolmate.main:lite
toolmateserver = toolmate.api_server:main
toolserver = toolmate.servers:main
visionserver = toolmate.servers:vision

